"a" = (/turf/wall,/area)
"b" = (/turf/floor,/area)
"c" = (/turf/start,/area)

(1,1,1) = {"
aaaaaaaaaa
abbbbbbbba
abbcbbbbba
abbbbbbbba
abbaabbbba
abbaabbbba
abbbbbbbba
abbbbbbbba
abbbbbbbba
aaaaaaaaaa
"}
