"a" = (/turf,/area)
"b" = (/turf/wall,/area)
"c" = (/obj/drink,/turf/floor,/area)
"d" = (/obj/torch,/turf/floor,/area)
"e" = (/turf/start,/area)
"f" = (/turf/wall/Iron_Wall,/area)
"g" = (/turf,/area/dark)
"h" = (/turf/floor,/area/dark)
"i" = (/obj/torch,/turf/floor,/area/dark)

(1,1,1) = {"
aaaaaaaaaaaaaaaaaaaaaaaaaaaaaaaaaaaaaaaaaaaaaaaaaa
aaaaaaaaaaaaaaaaaaaaaaaaaaaaaaaaaaaaaaaaaaaaaaaaaa
aaaaaaaaaaaaaaaaaaaaaaaaaaaaaaaaaaaaaaaaaaaaaaaaaa
aaaaaaaaaaaaaaaaaaaaaaaaaaaaaaaaaaaaaaaaaaaaaaaaaa
aaaaaaaaaaaaaaaaaaaaaaaaaaaaaaaaaaaaaaaaaaaaaaaaaa
aaaaaaaaaaaaaaaaaaaaaaaaaaaaaaaaaaaaaaaaaaaaaaaaaa
aaaaaaaaaaaaaaaaaaaaaaaaaaaaaaaaaaaaaaaaaaaaaaaaaa
aaaaaaaaaaaaaaaaaaaaaaaaaaaaaaaaaaaaaaaaaaaaaaaaaa
aaaaaaaaaaaaaaaaaaaaaaaaaaaaaaaaaaaaaaaaaaaaaaaaaa
aaaaaaaaaaaaaaaaaaaaaaaaaaaaaaaaaaaaaaaaaaaaaaaaaa
aaaaaaaaaaaaaaaaaaaaaaaaaaaaaaaaaaaaaaaaaaaaaaaaaa
aaaaaaaaaaaaaaaaaaaaaaaaaaaaaaaaaaaaaaaaaaaaaaaaaa
aaaaaaaaaaaaaaaaaaaaaaaaaaaaaaaaaaaaaaaaaaaaaaaaaa
aaaaaaaaaaaaaaaaaaaaaaaaaaaaaaaaaaaaaaaaaaaaaaaaaa
aaaaaaaaaaaaaaaaaaaaaaaaaaaaaaaaaaaaaaaaaaaaaaaaaa
aaaaaaaaaaaaaaaaaaaaaaaaaaaaaaaaaaaaaaaaaaaaaaaaaa
aaaaaaaaaaaaaaaaaaaaaaaaaaaaaaaaaaaaaaaaaaaaaaaaaa
aaaaaaaaaaaaaaaaaaaaaaaaaaaaaaaaaaaaaaaaaaaaaaaaaa
aaaaaaaaaaaaaaaaaaaaaaaaaaaaaaaaaaaaaaaaaaaaaaaaaa
aaaaaaaaaaaaaaaaaaaaaaaaaaaaaaaaaaaaaaaaaaaaaaaaaa
aaaaaaaaaaaaaaaaaaaaaaaaaaaaaaaaaaaaaaaaaaaaaaaaaa
aaaaaaaaaaaaaaaaaaaaaaaaaaaaaaaaaaaaaaaaaaaaaaaaaa
aaaaaaaaaaaaaaaaaaaaaaaaaaaaaaaaaaaaaaaaaaaaaaaaaa
aaaaaaaaaaaaaaaaaaaaaaaaaaaaaaaaaaaaaaaaaaaaaaaaaa
aaaaaaaaaaaaaaaaaaaaaaaaaaaaaaaaaaaaaaaaaaaaaaaaaa
aaaaaaaaaaaaaaaaaaaaaaaaaaaaaaaaaaaaaaaaaaaaaaaaaa
aaaaaaaaaaaaabbccbbaaaaaaaaaaaaaaaaaaaaaaaaaaaaaaa
aaaaaaaaaaaaaabccbaaaaaaaaaaaaaaaaaaaaaaaaaaaaaaaa
aaaaaaaaaaaaaabccbaaaaaaaaaaaaaaaaaaaaaaaaaaaaaaaa
aaaaaaaaaaaaabccccbaaaaaaaaaaaaaaaaaaaaaaaaaaaaaaa
aaaaaaaaaaaabccccccbaaaaaaaaaaaaaaaaaaaaaaaaaaaaaa
aaaaaaaaaaaabccccccbaaaaaaaaaaaaaaaaaaaaaaaaaaaaaa
aaaaaaaaaaaabccccdcbaaaaaaaaaaaaaaaaaaaaaaaaaaaaaa
aaaaaaaaaaaabccceccbaaaaaaaaaaaaaaaaaaaaaaaaaaaaaa
aaaaaaaaaaaabccccccbaaaaaaaaaaaaaaaaaaaaaaaaaaaaaa
aaaaaaaaaaaabccccccbaaaaaaaaaaaaaaaaaaaaaaaaaaaaaa
aaaaaaaaaaaabccccccbaaaaaaaaaaaaaaaaaaaaaaaaaaaaaa
aaaaaaaaaaaabccccccbaaaaaaaaaaaaaaaaaaaaaaaaaaaaaa
ffffffffffffffffffffffffffffffffffffaaaaaaaaaaaaaa
aaaaaaaaagggghhhhhhhhhhhhhhhhhhhhhhfaaaaaaaaaaaaaa
aaaaaaaaagggghhhhhhhhhhhhhhhhhhhhhhfaaaaaaaaaaaaaa
aaaaaaaaagggghhhhhhhhhhhhhhhhhhhihhfaaaaaaaaaaaaaa
aaaaaaaaagggghhhhhhhhhhhhhhhhhhhhhhfaaaaaaaaaaaaaa
aaaaaaaaagggghhhhhhhhhhhhhhhhhhhhhhfaaaaaaaaaaaaaa
aaaaaaaaagggghhhhhhhhhhhhhhhhhhhhhhfaaaaaaaaaaaaaa
aaaaaaaaagggghhhhhhhhhhhhhhhhhhhhhhfaaaaaaaaaaaaaa
aaaaaaaaagggghhhhhhhhhhhhhhhhhhhhhhfaaaaaaaaaaaaaa
aaaaaaaaagggghhhhhhhhhhhhhhhhhhhhhhfaaaaaaaaaaaaaa
aaaaaaaaagggghhhhhhhhhhhhhhhhhhhhhhfaaaaaaaaaaaaaa
aaaaaaaaagggghhhhhhhhhhhhhhhhhhhhhhfaaaaaaaaaaaaaa
"}
