"a" = (/turf/wall,/area/dark)
"b" = (/turf/wall,/area)
"c" = (/turf/floor,/area/dark)
"d" = (/turf/floor,/area)
"e" = (/obj/torch,/turf/floor,/area/dark)
"f" = (/turf/start,/area)
"g" = (/obj/torch,/turf/floor,/area)

(1,1,1) = {"
aaaaaabbbb
aaccccbbbb
bbbbacabdb
bbdebdcbbb
bccebdddbb
bcbfggddbb
bcbdggbddb
bcbbdbbddb
bccbdbdddb
bbbbbbbbbb
"}
