"a" = (/turf/wall,/area)
"b" = (/turf/floor,/area)
"c" = (/turf/start,/area)

(1,1,1) = {"
aaaaaaaaaa
aabbbbaaaa
aaaaabaaba
aabbabbaaa
abbbabbbaa
abacbbbbaa
ababbbabba
abaabaabba
abbababbba
aaaaaaaaaa
"}
